deadking 1 1
deadking/textures/tiles.png
24 8 24
5 2 5
 !!!!    !!!!    !!!,~08 !!!,~08 !!!,~08
 !!!!    !!!!    !!!!    !!!!    !!!!   

 !!!!    !!!!    !!!,~08 !!!,~08 !!!,~08
 !!!!    !!!!    !!!!    !!!!    !!!!   

 !!!-~08 !!!-~08 !!!-~08 !!!-~08 !!!-~08
 !!!!    !!!!    !!!!    !!!!    !!!!   

 !!!-~08 !!!-~08 !!!-~08 !!!-~08 !!!-~08
 !!!!    !!!!    !!!!    !!!!    !!!!   

 !!!-~08 !!!-~08 !!!-~08 !!!-~08 !!!-~08
 !!!!    !!!!    !!!!    !!!!    !!!!   

